24 24
E E E E E E E B E E E E E B E E E E E E E E E E
E E E E E E E B E E E E E B E E E E E E E E E E
E E E E E E E B E E E E E B E E E E E E E E E E
E E E E E E E B E E E E E B E E E E E E E E E E
E E E E E E E B E E E E E B E E E E E E E E E E
E E E E E E E B B B E B B B E E E E E E E E E E
E E E E E E E E E E E E E E E E E E E E E E E E
E E E E E E E E E E E E E E E E E E E E E E E E
E E E E E E E E E E E E E E E E E E E E E E E E
E E E E E E E E E E E E E E E E E E E E E E E E
E E E E E E E E E E E E E E E E E E E E E E E E
E E E E E E E E E E E E E E E E E E E E E E E E
E E E E E E E E E E E E E E E E E E E E E E E E
E E E E E E E E E E E E E E E E E E E E E E E E
E E E E E E E E E E E E E E B B B B B B B E E E
E E E E E E E E E E E E E E B E E E E E B E E E
E E E E E E E E E E E E E E B E E E E E B E E E
E E E E E E E E E E E E E E B E E E E E B E E E
E E E E E E E E E E E E E E B E E E E E B E E E
E E E E E E E E E E E E E E B E E E E E B E E E
E E E E E E E E E E E E E E B B B B B B B E E E
E E E E E E E E E E E E E E E E E E E E E E E E
E E E E E E E E E E E E E E E E E E E E E E E E
E E E E E E E E E E E E E E E E E E E E E E E E
{PLAYER}
2 2
{PLAYER}
4 4
{PLAYER}
6 6
{TELEPORT}
10 10 17 17
{TELEPORT}
4 4 5 5
{PRIZE}
10 0
{STONE}
1 1
{STONE}
1 2
{KEY}
18 18
{PLATE}
7 7 10 10
{GATE}
10 5
{SPIKE}
3 11 200
{PITFALL}
14 6 200
{HEALTHPACK}
22 16 150
{CATAPULT}
15 5 5 LEFT
{CATAPULT}
0 23 5 DOWN
{CATAPULT}
23 0 5 DOWN
{CATAPULT}
23 23 5 DOWN
{LEVER}
17 10 10 10