24 24 1 5
G G B E E E E E E E E E E E E E E E E E E E E E
E E B E E E E E E E E E E E E E E E E E E E E E
E E B E E B B B B B B B B B B B B B B B B B E E
E E B E E B E E E E E E E E E E E E E E E B E E
E E B E E B E E E E E E E E E E E E E E E B E E
E E B E E B E E B B B B B B B B B B B E E B E E
E E B E E B E E B E E E E E E E E E B E E B E E
E E B E E B E E B E E E E E E E E E B E E B E E
E E B E E B E E B E E B B B B B E E B E E B E E
E E B E E B E E B E E B E E E B E E B E E B E E
E E B E E B E E B E E B E E E B E E B E E B E E
E E B E E B E E B E E B E E E B E E B E E B E E
E E B E E B E E B E E B B B E B E E B E E B E E
E E B E E B E E B E E E E E E B E E B E E B E E
E E B E E B E E B E E E E E E B E E B E E B E E
E E B E E B E E B B B B B B B B E E B E E B E E
E E B E E B E E E E E E E E E E E E B E E B E E
E E B E E B E E E E E E E E E E E E B E E B E E
E E B E E B B B B B B B B B B B B B B E E B E E
E E B E E E E E E E E E E E E E E E E E E B E E
E E B E E E E E E E E E E E E E E E E E E B E E
E E B B B B B B B B B B B B B B B B B B B B E E
E E E E E E E E E E E E E E E E E E E E E E E E
E E E E E E E E E E E E E E E E E E E E E E E E
{PRIZE}
10 0